1111111111111
1000C00000001
101C001101101
1P0011E000C01
1111111111111