111111111111111111111
1000000000C0000C00001
101001010010001110101
1X10010X1X101010X0101
1PX000X00C00C01000101
100100C000X0001000001
10C10000000C001111001
1001001111111110C0X01
10010000C0000X0000001
100C0000000E0000C01C1
111111111111111111111